State Code,State Name,Age Group,TOT_P,TOT_M,TOT_F
00,India,All ages,1210854977,623270258,587584719
00,India,0-4,112806778,58632074,54174704
00,India,5-9,126928126,66300466,60627660
00,India,10-14,132709212,69418835,63290377
00,India,15-19,120526449,63982396,56544053
00,India,20-24,111424222,57584693,53839529
00,India,25-29,101413965,51344208,50069757
00,India,30-34,88594951,44660674,43934277
00,India,35-39,85140684,42919381,42221303
00,India,40-44,72438112,37545386,34892726
00,India,45-49,62318327,32138114,30180213
00,India,50-54,49069254,25843266,23225988
00,India,55-59,39146055,19456012,19690043
00,India,60-64,37663707,18701749,18961958
00,India,65-69,26454983,12944326,13510657
00,India,70-74,19208842,9651499,9557343
00,India,75-79,9232503,4490603,4741900
00,India,80+,11289005,5283695,6005310
00,India,Age not stated,4489802,2372881,2116921
01,JAMMU & KASHMIR (01),All ages,12541302,6640662,5900640
01,JAMMU & KASHMIR (01),0-4,1414884,763501,651383
01,JAMMU & KASHMIR (01),5-9,1411973,746818,665155
01,JAMMU & KASHMIR (01),10-14,1413853,744855,668998
01,JAMMU & KASHMIR (01),15-19,1237462,640362,597100
01,JAMMU & KASHMIR (01),20-24,1160913,603578,557335
01,JAMMU & KASHMIR (01),25-29,1086122,584559,501563
01,JAMMU & KASHMIR (01),30-34,926903,495746,431157
01,JAMMU & KASHMIR (01),35-39,837945,441265,396680
01,JAMMU & KASHMIR (01),40-44,714085,387739,326346
01,JAMMU & KASHMIR (01),45-49,590790,311560,279230
01,JAMMU & KASHMIR (01),50-54,468566,255599,212967
01,JAMMU & KASHMIR (01),55-59,340031,172753,167278
01,JAMMU & KASHMIR (01),60-64,322726,173427,149299
01,JAMMU & KASHMIR (01),65-69,203965,102743,101222
01,JAMMU & KASHMIR (01),70-74,184019,97472,86547
01,JAMMU & KASHMIR (01),75-79,85076,43094,41982
01,JAMMU & KASHMIR (01),80+,126870,65844,61026
01,JAMMU & KASHMIR (01),Age not stated,15119,9747,5372
02,HIMACHAL PRADESH (02),All ages,6864602,3481873,3382729
02,HIMACHAL PRADESH (02),0-4,544984,285011,259973
02,HIMACHAL PRADESH (02),5-9,591177,311457,279720
02,HIMACHAL PRADESH (02),10-14,639224,338240,300984
02,HIMACHAL PRADESH (02),15-19,640461,336729,303732
02,HIMACHAL PRADESH (02),20-24,643866,323720,320146
02,HIMACHAL PRADESH (02),25-29,589160,290125,299035
02,HIMACHAL PRADESH (02),30-34,546357,271253,275104
02,HIMACHAL PRADESH (02),35-39,517966,258230,259736
02,HIMACHAL PRADESH (02),40-44,445560,222269,223291
02,HIMACHAL PRADESH (02),45-49,395128,197642,197486
02,HIMACHAL PRADESH (02),50-54,330687,165724,164963
02,HIMACHAL PRADESH (02),55-59,266860,135245,131615
02,HIMACHAL PRADESH (02),60-64,231372,115464,115908
02,HIMACHAL PRADESH (02),65-69,158607,78387,80220
02,HIMACHAL PRADESH (02),70-74,130587,62119,68468
02,HIMACHAL PRADESH (02),75-79,75706,36440,39266
02,HIMACHAL PRADESH (02),80+,106737,48465,58272
02,HIMACHAL PRADESH (02),Age not stated,10163,5353,4810
03,PUNJAB (03),All ages,27743338,14639465,13103873
03,PUNJAB (03),0-4,2133529,1149956,983573
03,PUNJAB (03),5-9,2368019,1301682,1066337
03,PUNJAB (03),10-14,2583402,1445530,1137872
03,PUNJAB (03),15-19,2817683,1570180,1247503
03,PUNJAB (03),20-24,2776636,1465531,1311105
03,PUNJAB (03),25-29,2463861,1270405,1193456
03,PUNJAB (03),30-34,2116539,1082533,1034006
03,PUNJAB (03),35-39,1989071,1010862,978209
03,PUNJAB (03),40-44,1788469,909208,879261
03,PUNJAB (03),45-49,1587771,818135,769636
03,PUNJAB (03),50-54,1254464,663664,590800
03,PUNJAB (03),55-59,956555,485845,470710
03,PUNJAB (03),60-64,996590,482483,514107
03,PUNJAB (03),65-69,719588,372806,346782
03,PUNJAB (03),70-74,513472,272120,241352
03,PUNJAB (03),75-79,256666,130203,126463
03,PUNJAB (03),80+,379501,186050,193451
03,PUNJAB (03),Age not stated,41522,22272,19250
04,CHANDIGARH (04),All ages,1055450,580663,474787
04,CHANDIGARH (04),0-4,81854,43347,38507
04,CHANDIGARH (04),5-9,91194,49255,41939
04,CHANDIGARH (04),10-14,93464,52140,41324
04,CHANDIGARH (04),15-19,104418,60521,43897
04,CHANDIGARH (04),20-24,121244,68467,52777
04,CHANDIGARH (04),25-29,110237,60694,49543
04,CHANDIGARH (04),30-34,90803,49625,41178
04,CHANDIGARH (04),35-39,83672,45566,38106
04,CHANDIGARH (04),40-44,68921,37268,31653
04,CHANDIGARH (04),45-49,60352,32893,27459
04,CHANDIGARH (04),50-54,46942,26108,20834
04,CHANDIGARH (04),55-59,34925,19745,15180
04,CHANDIGARH (04),60-64,25801,13530,12271
04,CHANDIGARH (04),65-69,15839,8250,7589
04,CHANDIGARH (04),70-74,11385,5998,5387
04,CHANDIGARH (04),75-79,6422,3255,3167
04,CHANDIGARH (04),80+,7631,3800,3831
04,CHANDIGARH (04),Age not stated,346,201,145
05,UTTARAKHAND (05),All ages,10086292,5137773,4948519
05,UTTARAKHAND (05),0-4,924864,488988,435876
05,UTTARAKHAND (05),5-9,1058801,560179,498622
05,UTTARAKHAND (05),10-14,1145343,603274,542069
05,UTTARAKHAND (05),15-19,1124110,588483,535627
05,UTTARAKHAND (05),20-24,970068,484614,485454
05,UTTARAKHAND (05),25-29,810184,397363,412821
05,UTTARAKHAND (05),30-34,698300,345427,352873
05,UTTARAKHAND (05),35-39,665500,330834,334666
05,UTTARAKHAND (05),40-44,566709,285531,281178
05,UTTARAKHAND (05),45-49,489377,247982,241395
05,UTTARAKHAND (05),50-54,397158,202024,195134
05,UTTARAKHAND (05),55-59,318461,151865,166596
05,UTTARAKHAND (05),60-64,329056,163220,165836
05,UTTARAKHAND (05),65-69,218759,108412,110347
05,UTTARAKHAND (05),70-74,163443,80970,82473
05,UTTARAKHAND (05),75-79,84646,40837,43809
05,UTTARAKHAND (05),80+,104905,48458,56447
05,UTTARAKHAND (05),Age not stated,16608,9312,7296
06,HARYANA (06),All ages,25351462,13494734,11856728
06,HARYANA (06),0-4,2362519,1283789,1078730
06,HARYANA (06),5-9,2498757,1371825,1126932
06,HARYANA (06),10-14,2668678,1474136,1194542
06,HARYANA (06),15-19,2677390,1487548,1189842
06,HARYANA (06),20-24,2567486,1372799,1194687
06,HARYANA (06),25-29,2231959,1178340,1053619
06,HARYANA (06),30-34,1893591,976844,916747
06,HARYANA (06),35-39,1761863,912717,849146
06,HARYANA (06),40-44,1505950,790581,715369
06,HARYANA (06),45-49,1241814,655749,586065
06,HARYANA (06),50-54,965228,510688,454540
06,HARYANA (06),55-59,750938,374209,376729
06,HARYANA (06),60-64,844349,413958,430391
06,HARYANA (06),65-69,504439,255270,249169
06,HARYANA (06),70-74,374161,188304,185857
06,HARYANA (06),75-79,196217,97692,98525
06,HARYANA (06),80+,274589,133397,141192
06,HARYANA (06),Age not stated,31534,16888,14646
07,NCT OF DELHI (07),All ages,16787941,8987326,7800615
07,NCT OF DELHI (07),0-4,1381200,734336,646864
07,NCT OF DELHI (07),5-9,1535972,829487,706485
07,NCT OF DELHI (07),10-14,1648147,895446,752701
07,NCT OF DELHI (07),15-19,1667375,925118,742257
07,NCT OF DELHI (07),20-24,1764060,951411,812649
07,NCT OF DELHI (07),25-29,1668326,878196,790130
07,NCT OF DELHI (07),30-34,1434699,757455,677244
07,NCT OF DELHI (07),35-39,1319244,698455,620789
07,NCT OF DELHI (07),40-44,1097197,590858,506339
07,NCT OF DELHI (07),45-49,911213,495227,415986
07,NCT OF DELHI (07),50-54,687469,376222,311247
07,NCT OF DELHI (07),55-59,508892,269185,239707
07,NCT OF DELHI (07),60-64,472019,238103,233916
07,NCT OF DELHI (07),65-69,272452,139398,133054
07,NCT OF DELHI (07),70-74,189250,94947,94303
07,NCT OF DELHI (07),75-79,100693,50446,50247
07,NCT OF DELHI (07),80+,113031,53861,59170
07,NCT OF DELHI (07),Age not stated,16702,9175,7527
08,RAJASTHAN (08),All ages,68548437,35550997,32997440
08,RAJASTHAN (08),0-4,7302170,3858574,3443596
08,RAJASTHAN (08),5-9,8042738,4258873,3783865
08,RAJASTHAN (08),10-14,8380518,4430696,3949822
08,RAJASTHAN (08),15-19,7314017,3889874,3424143
08,RAJASTHAN (08),20-24,6426494,3377483,3049011
08,RAJASTHAN (08),25-29,5348497,2763059,2585438
08,RAJASTHAN (08),30-34,4722683,2384569,2338114
08,RAJASTHAN (08),35-39,4334564,2201790,2132774
08,RAJASTHAN (08),40-44,3735355,1926916,1808439
08,RAJASTHAN (08),45-49,3145404,1608512,1536892
08,RAJASTHAN (08),50-54,2516808,1345007,1171801
08,RAJASTHAN (08),55-59,1897449,935866,961583
08,RAJASTHAN (08),60-64,1770139,884024,886115
08,RAJASTHAN (08),65-69,1260376,589471,670905
08,RAJASTHAN (08),70-74,1016915,490011,526904
08,RAJASTHAN (08),75-79,477655,216016,261639
08,RAJASTHAN (08),80+,587053,252741,334312
08,RAJASTHAN (08),Age not stated,269602,137515,132087
09,UTTAR PRADESH (09),All ages,199812341,104480510,95331831
09,UTTAR PRADESH (09),0-4,20376668,10660474,9716194
09,UTTAR PRADESH (09),5-9,25061717,13250331,11811386
09,UTTAR PRADESH (09),10-14,25869881,13679154,12190727
09,UTTAR PRADESH (09),15-19,23040380,12307573,10732807
09,UTTAR PRADESH (09),20-24,17578648,9405485,8173163
09,UTTAR PRADESH (09),25-29,14579829,7466367,7113462
09,UTTAR PRADESH (09),30-34,12954682,6431401,6523281
09,UTTAR PRADESH (09),35-39,12556222,6401231,6154991
09,UTTAR PRADESH (09),40-44,10231402,5395162,4836240
09,UTTAR PRADESH (09),45-49,8449777,4382148,4067629
09,UTTAR PRADESH (09),50-54,6587023,3571917,3015106
09,UTTAR PRADESH (09),55-59,5464146,2626201,2837945
09,UTTAR PRADESH (09),60-64,5705191,2968771,2736420
09,UTTAR PRADESH (09),65-69,3839969,1958472,1881497
09,UTTAR PRADESH (09),70-74,2832368,1535092,1297276
09,UTTAR PRADESH (09),75-79,1249892,638877,611015
09,UTTAR PRADESH (09),80+,1812484,935921,876563
09,UTTAR PRADESH (09),Age not stated,1622062,865933,756129
10,BIHAR (10),All ages,104099452,54278157,49821295
10,BIHAR (10),0-4,12765029,6576871,6188158
10,BIHAR (10),5-9,15036277,7796359,7239918
10,BIHAR (10),10-14,13919882,7323831,6596051
10,BIHAR (10),15-19,9472695,5290581,4182114
10,BIHAR (10),20-24,8064735,4210585,3854150
10,BIHAR (10),25-29,7671705,3828687,3843018
10,BIHAR (10),30-34,7055737,3510596,3545141
10,BIHAR (10),35-39,6457261,3308161,3149100
10,BIHAR (10),40-44,5165692,2756809,2408883
10,BIHAR (10),45-49,4270374,2209994,2060380
10,BIHAR (10),50-54,3312740,1808425,1504315
10,BIHAR (10),55-59,2796678,1330356,1466322
10,BIHAR (10),60-64,3008008,1559925,1448083
10,BIHAR (10),65-69,2089779,1103718,986061
10,BIHAR (10),70-74,1379531,784383,595148
10,BIHAR (10),75-79,550479,297973,252506
10,BIHAR (10),80+,679348,360594,318754
10,BIHAR (10),Age not stated,403502,220309,183193
11,SIKKIM (11),All ages,610577,323070,287507
11,SIKKIM (11),0-4,42336,21685,20651
11,SIKKIM (11),5-9,56678,28688,27990
11,SIKKIM (11),10-14,66923,33965,32958
11,SIKKIM (11),15-19,66937,33998,32939
11,SIKKIM (11),20-24,67297,35146,32151
11,SIKKIM (11),25-29,64639,34700,29939
11,SIKKIM (11),30-34,52225,28562,23663
11,SIKKIM (11),35-39,43627,23396,20231
11,SIKKIM (11),40-44,36552,20170,16382
11,SIKKIM (11),45-49,29462,16114,13348
11,SIKKIM (11),50-54,24432,13624,10808
11,SIKKIM (11),55-59,17541,9913,7628
11,SIKKIM (11),60-64,13550,7441,6109
11,SIKKIM (11),65-69,10483,5593,4890
11,SIKKIM (11),70-74,7561,4304,3257
11,SIKKIM (11),75-79,4516,2556,1960
11,SIKKIM (11),80+,4642,2578,2064
11,SIKKIM (11),Age not stated,1176,637,539
12,ARUNACHAL PRADESH (12),All ages,1383727,713912,669815
12,ARUNACHAL PRADESH (12),0-4,142879,72464,70415
12,ARUNACHAL PRADESH (12),5-9,171123,86699,84424
12,ARUNACHAL PRADESH (12),10-14,179359,90439,88920
12,ARUNACHAL PRADESH (12),15-19,155968,78673,77295
12,ARUNACHAL PRADESH (12),20-24,131696,66033,65663
12,ARUNACHAL PRADESH (12),25-29,123714,63366,60348
12,ARUNACHAL PRADESH (12),30-34,101171,52462,48709
12,ARUNACHAL PRADESH (12),35-39,94391,48211,46180
12,ARUNACHAL PRADESH (12),40-44,78603,42861,35742
12,ARUNACHAL PRADESH (12),45-49,63679,35173,28506
12,ARUNACHAL PRADESH (12),50-54,46110,26487,19623
12,ARUNACHAL PRADESH (12),55-59,29886,16996,12890
12,ARUNACHAL PRADESH (12),60-64,25445,13492,11953
12,ARUNACHAL PRADESH (12),65-69,14973,7642,7331
12,ARUNACHAL PRADESH (12),70-74,10647,5547,5100
12,ARUNACHAL PRADESH (12),75-79,5135,2687,2448
12,ARUNACHAL PRADESH (12),80+,7439,3821,3618
12,ARUNACHAL PRADESH (12),Age not stated,1509,859,650
13,NAGALAND (13),All ages,1978502,1024649,953853
13,NAGALAND (13),0-4,197262,101291,95971
13,NAGALAND (13),5-9,233099,120647,112452
13,NAGALAND (13),10-14,248671,129237,119434
13,NAGALAND (13),15-19,229622,117994,111628
13,NAGALAND (13),20-24,204363,103769,100594
13,NAGALAND (13),25-29,176901,89598,87303
13,NAGALAND (13),30-34,149924,76505,73419
13,NAGALAND (13),35-39,128198,64695,63503
13,NAGALAND (13),40-44,109261,57653,51608
13,NAGALAND (13),45-49,87747,47757,39990
13,NAGALAND (13),50-54,65859,36134,29725
13,NAGALAND (13),55-59,43398,23741,19657
13,NAGALAND (13),60-64,36519,19683,16836
13,NAGALAND (13),65-69,24243,12801,11442
13,NAGALAND (13),70-74,17593,9260,8333
13,NAGALAND (13),75-79,10565,5635,4930
13,NAGALAND (13),80+,13806,7400,6406
13,NAGALAND (13),Age not stated,1471,849,622
14,MANIPUR (14),All ages,2855794,1438586,1417208
14,MANIPUR (14),0-4,256682,133160,123522
14,MANIPUR (14),5-9,291243,149766,141477
14,MANIPUR (14),10-14,313763,161146,152617
14,MANIPUR (14),15-19,287008,144495,142513
14,MANIPUR (14),20-24,281782,139587,142195
14,MANIPUR (14),25-29,270477,132888,137589
14,MANIPUR (14),30-34,220954,109678,111276
14,MANIPUR (14),35-39,198453,98019,100434
14,MANIPUR (14),40-44,170829,85896,84933
14,MANIPUR (14),45-49,147030,73917,73113
14,MANIPUR (14),50-54,120277,60598,59679
14,MANIPUR (14),55-59,89499,45409,44090
14,MANIPUR (14),60-64,71897,36567,35330
14,MANIPUR (14),65-69,46648,23218,23430
14,MANIPUR (14),70-74,34253,16776,17477
14,MANIPUR (14),75-79,21428,10663,10765
14,MANIPUR (14),80+,25794,12571,13223
14,MANIPUR (14),Age not stated,7777,4232,3545
15,MIZORAM (15),All ages,1097206,555339,541867
15,MIZORAM (15),0-4,121233,61541,59692
15,MIZORAM (15),5-9,117788,59888,57900
15,MIZORAM (15),10-14,116981,59526,57455
15,MIZORAM (15),15-19,110343,55907,54436
15,MIZORAM (15),20-24,111708,55512,56196
15,MIZORAM (15),25-29,102346,51390,50956
15,MIZORAM (15),30-34,88374,44341,44033
15,MIZORAM (15),35-39,72384,36817,35567
15,MIZORAM (15),40-44,58180,29970,28210
15,MIZORAM (15),45-49,53175,27028,26147
15,MIZORAM (15),50-54,44256,22556,21700
15,MIZORAM (15),55-59,31177,16139,15038
15,MIZORAM (15),60-64,24480,12357,12123
15,MIZORAM (15),65-69,16170,8114,8056
15,MIZORAM (15),70-74,12020,6108,5912
15,MIZORAM (15),75-79,7784,3884,3900
15,MIZORAM (15),80+,8174,3882,4292
15,MIZORAM (15),Age not stated,633,379,254
16,TRIPURA (16),All ages,3673917,1874376,1799541
16,TRIPURA (16),0-4,322566,164505,158061
16,TRIPURA (16),5-9,337735,172541,165194
16,TRIPURA (16),10-14,357690,183001,174689
16,TRIPURA (16),15-19,357829,181136,176693
16,TRIPURA (16),20-24,373177,183779,189398
16,TRIPURA (16),25-29,344149,175059,169090
16,TRIPURA (16),30-34,286989,149231,137758
16,TRIPURA (16),35-39,279342,143051,136291
16,TRIPURA (16),40-44,238751,124093,114658
16,TRIPURA (16),45-49,205469,106717,98752
16,TRIPURA (16),50-54,162186,86627,75559
16,TRIPURA (16),55-59,116874,61849,55025
16,TRIPURA (16),60-64,97129,49611,47518
16,TRIPURA (16),65-69,70480,35044,35436
16,TRIPURA (16),70-74,52324,25535,26789
16,TRIPURA (16),75-79,30086,14259,15827
16,TRIPURA (16),80+,39525,17471,22054
16,TRIPURA (16),Age not stated,1616,867,749
17,MEGHALAYA (17),All ages,2966889,1491832,1475057
17,MEGHALAYA (17),0-4,406154,205846,200308
17,MEGHALAYA (17),5-9,389182,197585,191597
17,MEGHALAYA (17),10-14,382606,193473,189133
17,MEGHALAYA (17),15-19,326188,164716,161472
17,MEGHALAYA (17),20-24,285012,139140,145872
17,MEGHALAYA (17),25-29,251281,124676,126605
17,MEGHALAYA (17),30-34,189657,95786,93871
17,MEGHALAYA (17),35-39,174706,87320,87386
17,MEGHALAYA (17),40-44,145450,73377,72073
17,MEGHALAYA (17),45-49,123115,63043,60072
17,MEGHALAYA (17),50-54,88743,45910,42833
17,MEGHALAYA (17),55-59,60109,30692,29417
17,MEGHALAYA (17),60-64,50708,25421,25287
17,MEGHALAYA (17),65-69,35774,17482,18292
17,MEGHALAYA (17),70-74,23698,11161,12537
17,MEGHALAYA (17),75-79,12845,5848,6997
17,MEGHALAYA (17),80+,15877,7027,8850
17,MEGHALAYA (17),Age not stated,5784,3329,2455
18,ASSAM (18),All ages,31205576,15939443,15266133
18,ASSAM (18),0-4,3212833,1634922,1577911
18,ASSAM (18),5-9,3544339,1806346,1737993
18,ASSAM (18),10-14,3491727,1789381,1702346
18,ASSAM (18),15-19,3068581,1595489,1473092
18,ASSAM (18),20-24,2909405,1415580,1493825
18,ASSAM (18),25-29,2815147,1393042,1422105
18,ASSAM (18),30-34,2330060,1174247,1155813
18,ASSAM (18),35-39,2260473,1153679,1106794
18,ASSAM (18),40-44,1831206,965463,865743
18,ASSAM (18),45-49,1595249,846081,749168
18,ASSAM (18),50-54,1192363,642260,550103
18,ASSAM (18),55-59,856825,458242,398583
18,ASSAM (18),60-64,775698,394563,381135
18,ASSAM (18),65-69,503642,253973,249669
18,ASSAM (18),70-74,385277,196445,188832
18,ASSAM (18),75-79,184352,96599,87753
18,ASSAM (18),80+,229575,113237,116338
18,ASSAM (18),Age not stated,18824,9894,8930
19,WEST BENGAL (19),All ages,91276115,46809027,44467088
19,WEST BENGAL (19),0-4,7333143,3743862,3589281
19,WEST BENGAL (19),5-9,8247809,4216763,4031046
19,WEST BENGAL (19),10-14,9156523,4677506,4479017
19,WEST BENGAL (19),15-19,9058031,4702325,4355706
19,WEST BENGAL (19),20-24,8758322,4422630,4335692
19,WEST BENGAL (19),25-29,7997909,4044904,3953005
19,WEST BENGAL (19),30-34,6841590,3464659,3376931
19,WEST BENGAL (19),35-39,7012646,3523361,3489285
19,WEST BENGAL (19),40-44,6153060,3219604,2933456
19,WEST BENGAL (19),45-49,5335719,2814212,2521507
19,WEST BENGAL (19),50-54,4257880,2317232,1940648
19,WEST BENGAL (19),55-59,3268650,1746903,1521747
19,WEST BENGAL (19),60-64,2745454,1406401,1339053
19,WEST BENGAL (19),65-69,1982993,991280,991713
19,WEST BENGAL (19),70-74,1390607,686881,703726
19,WEST BENGAL (19),75-79,739767,360216,379551
19,WEST BENGAL (19),80+,883561,406536,477025
19,WEST BENGAL (19),Age not stated,112451,63752,48699
20,JHARKHAND (20),All ages,32988134,16930315,16057819
20,JHARKHAND (20),0-4,3648297,1871134,1777163
20,JHARKHAND (20),5-9,4138425,2117879,2020546
20,JHARKHAND (20),10-14,4104396,2112627,1991769
20,JHARKHAND (20),15-19,3205268,1714887,1490381
20,JHARKHAND (20),20-24,2827622,1431263,1396359
20,JHARKHAND (20),25-29,2652639,1342314,1310325
20,JHARKHAND (20),30-34,2307296,1165866,1141430
20,JHARKHAND (20),35-39,2136764,1092675,1044089
20,JHARKHAND (20),40-44,1788506,930421,858085
20,JHARKHAND (20),45-49,1534094,798966,735128
20,JHARKHAND (20),50-54,1186181,620682,565499
20,JHARKHAND (20),55-59,985234,487604,497630
20,JHARKHAND (20),60-64,957482,474565,482917
20,JHARKHAND (20),65-69,635397,317852,317545
20,JHARKHAND (20),70-74,407108,210878,196230
20,JHARKHAND (20),75-79,167954,83542,84412
20,JHARKHAND (20),80+,188737,94908,93829
20,JHARKHAND (20),Age not stated,116734,62252,54482
21,ODISHA (21),All ages,41974218,21212136,20762082
21,ODISHA (21),0-4,3653029,1878127,1774902
21,ODISHA (21),5-9,4074768,2085339,1989429
21,ODISHA (21),10-14,4348625,2203535,2145090
21,ODISHA (21),15-19,3925398,1972684,1952714
21,ODISHA (21),20-24,3783527,1870939,1912588
21,ODISHA (21),25-29,3574037,1772876,1801161
21,ODISHA (21),30-34,3102991,1542233,1560758
21,ODISHA (21),35-39,3051188,1528685,1522503
21,ODISHA (21),40-44,2691474,1387920,1303554
21,ODISHA (21),45-49,2334030,1212366,1121664
21,ODISHA (21),50-54,1847812,957524,890288
21,ODISHA (21),55-59,1483720,744291,739429
21,ODISHA (21),60-64,1474061,737635,736426
21,ODISHA (21),65-69,979525,487849,491676
21,ODISHA (21),70-74,768070,380635,387435
21,ODISHA (21),75-79,364800,183294,181506
21,ODISHA (21),80+,397992,204857,193135
21,ODISHA (21),Age not stated,119171,61347,57824
22,CHHATTISGARH (22),All ages,25545198,12832895,12712303
22,CHHATTISGARH (22),0-4,2541065,1286970,1254095
22,CHHATTISGARH (22),5-9,2758758,1404079,1354679
22,CHHATTISGARH (22),10-14,2884013,1461185,1422828
22,CHHATTISGARH (22),15-19,2599842,1319451,1280391
22,CHHATTISGARH (22),20-24,2389497,1193378,1196119
22,CHHATTISGARH (22),25-29,2057300,1049238,1008062
22,CHHATTISGARH (22),30-34,1815058,898023,917035
22,CHHATTISGARH (22),35-39,1779414,891265,888149
22,CHHATTISGARH (22),40-44,1576553,796402,780151
22,CHHATTISGARH (22),45-49,1334374,692974,641400
22,CHHATTISGARH (22),50-54,992947,510326,482621
22,CHHATTISGARH (22),55-59,789353,389338,400015
22,CHHATTISGARH (22),60-64,743742,348956,394786
22,CHHATTISGARH (22),65-69,533810,244336,289474
22,CHHATTISGARH (22),70-74,373000,174249,198751
22,CHHATTISGARH (22),75-79,166578,75545,91033
22,CHHATTISGARH (22),80+,186779,85073,101706
22,CHHATTISGARH (22),Age not stated,23115,12107,11008
23,MADHYA PRADESH (23),All ages,72626809,37612306,35014503
23,MADHYA PRADESH (23),0-4,7471286,3874247,3597039
23,MADHYA PRADESH (23),5-9,8266455,4309693,3956762
23,MADHYA PRADESH (23),10-14,8564501,4439329,4125172
23,MADHYA PRADESH (23),15-19,7446789,3980072,3466717
23,MADHYA PRADESH (23),20-24,6727579,3554088,3173491
23,MADHYA PRADESH (23),25-29,5787506,2988325,2799181
23,MADHYA PRADESH (23),30-34,5214960,2650705,2564255
23,MADHYA PRADESH (23),35-39,4861671,2493464,2368207
23,MADHYA PRADESH (23),40-44,4214474,2193888,2020586
23,MADHYA PRADESH (23),45-49,3522961,1838798,1684163
23,MADHYA PRADESH (23),50-54,2694372,1446522,1247850
23,MADHYA PRADESH (23),55-59,2058077,1030243,1027834
23,MADHYA PRADESH (23),60-64,1987410,989463,997947
23,MADHYA PRADESH (23),65-69,1427061,680005,747056
23,MADHYA PRADESH (23),70-74,1107421,545246,562175
23,MADHYA PRADESH (23),75-79,523355,244807,278548
23,MADHYA PRADESH (23),80+,668069,310035,358034
23,MADHYA PRADESH (23),Age not stated,82862,43376,39486
24,GUJARAT (24),All ages,60439692,31491260,28948432
24,GUJARAT (24),0-4,5460332,2871890,2588442
24,GUJARAT (24),5-9,5835836,3126401,2709435
24,GUJARAT (24),10-14,6149445,3283834,2865611
24,GUJARAT (24),15-19,5865760,3146110,2719650
24,GUJARAT (24),20-24,5780722,3046127,2734595
24,GUJARAT (24),25-29,5278822,2767283,2511539
24,GUJARAT (24),30-34,4770528,2467024,2303504
24,GUJARAT (24),35-39,4341225,2258335,2082890
24,GUJARAT (24),40-44,3865476,1993876,1871600
24,GUJARAT (24),45-49,3314013,1711872,1602141
24,GUJARAT (24),50-54,2697183,1409273,1287910
24,GUJARAT (24),55-59,2054947,1038088,1016859
24,GUJARAT (24),60-64,1727752,851259,876493
24,GUJARAT (24),65-69,1170072,550002,620070
24,GUJARAT (24),70-74,899677,417522,482155
24,GUJARAT (24),75-79,439996,196341,243655
24,GUJARAT (24),80+,549062,230477,318585
24,GUJARAT (24),Age not stated,238844,125546,113298
25,DAMAN & DIU (25),All ages,243247,150301,92946
25,DAMAN & DIU (25),0-4,19158,10020,9138
25,DAMAN & DIU (25),5-9,18506,9828,8678
25,DAMAN & DIU (25),10-14,17321,9300,8021
25,DAMAN & DIU (25),15-19,26314,18239,8075
25,DAMAN & DIU (25),20-24,38584,27925,10659
25,DAMAN & DIU (25),25-29,33181,22044,11137
25,DAMAN & DIU (25),30-34,24031,15314,8717
25,DAMAN & DIU (25),35-39,19550,12255,7295
25,DAMAN & DIU (25),40-44,13601,8384,5217
25,DAMAN & DIU (25),45-49,9618,5649,3969
25,DAMAN & DIU (25),50-54,6610,3646,2964
25,DAMAN & DIU (25),55-59,5056,2576,2480
25,DAMAN & DIU (25),60-64,4308,1977,2331
25,DAMAN & DIU (25),65-69,2753,1182,1571
25,DAMAN & DIU (25),70-74,2103,841,1262
25,DAMAN & DIU (25),75-79,1067,437,630
25,DAMAN & DIU (25),80+,1130,436,694
25,DAMAN & DIU (25),Age not stated,356,248,108
26,DADRA & NAGAR HAVELI (26),All ages,343709,193760,149949
26,DADRA & NAGAR HAVELI (26),0-4,36561,18902,17659
26,DADRA & NAGAR HAVELI (26),5-9,36249,19059,17190
26,DADRA & NAGAR HAVELI (26),10-14,35003,18385,16618
26,DADRA & NAGAR HAVELI (26),15-19,33104,19979,13125
26,DADRA & NAGAR HAVELI (26),20-24,44301,27595,16706
26,DADRA & NAGAR HAVELI (26),25-29,39885,23496,16389
26,DADRA & NAGAR HAVELI (26),30-34,30641,17957,12684
26,DADRA & NAGAR HAVELI (26),35-39,25277,14862,10415
26,DADRA & NAGAR HAVELI (26),40-44,18181,10554,7627
26,DADRA & NAGAR HAVELI (26),45-49,13789,7671,6118
26,DADRA & NAGAR HAVELI (26),50-54,9503,5215,4288
26,DADRA & NAGAR HAVELI (26),55-59,6951,3526,3425
26,DADRA & NAGAR HAVELI (26),60-64,5831,2794,3037
26,DADRA & NAGAR HAVELI (26),65-69,3716,1755,1961
26,DADRA & NAGAR HAVELI (26),70-74,2309,973,1336
26,DADRA & NAGAR HAVELI (26),75-79,958,394,564
26,DADRA & NAGAR HAVELI (26),80+,1078,443,635
26,DADRA & NAGAR HAVELI (26),Age not stated,372,200,172
27,MAHARASHTRA (27),All ages,112374333,58243056,54131277
27,MAHARASHTRA (27),0-4,9362026,4939629,4422397
27,MAHARASHTRA (27),5-9,9820654,5178177,4642477
27,MAHARASHTRA (27),10-14,10734535,5662261,5072274
27,MAHARASHTRA (27),15-19,10627267,5710400,4916867
27,MAHARASHTRA (27),20-24,11090966,5845114,5245852
27,MAHARASHTRA (27),25-29,10147113,5272560,4874553
27,MAHARASHTRA (27),30-34,8796307,4536297,4260010
27,MAHARASHTRA (27),35-39,8247160,4209434,4037726
27,MAHARASHTRA (27),40-44,7196089,3744825,3451264
27,MAHARASHTRA (27),45-49,6032454,3116218,2916236
27,MAHARASHTRA (27),50-54,4919317,2580991,2338326
27,MAHARASHTRA (27),55-59,3885814,1974129,1911685
27,MAHARASHTRA (27),60-64,3642480,1716639,1925841
27,MAHARASHTRA (27),65-69,3078352,1440238,1638114
27,MAHARASHTRA (27),70-74,2143136,1039292,1103844
27,MAHARASHTRA (27),75-79,1062773,515431,547342
27,MAHARASHTRA (27),80+,1180194,542109,638085
27,MAHARASHTRA (27),Age not stated,407696,219312,188384
28,ANDHRA PRADESH (28),All ages,84580777,42442146,42138631
28,ANDHRA PRADESH (28),0-4,6284765,3235887,3048878
28,ANDHRA PRADESH (28),5-9,7304432,3760398,3544034
28,ANDHRA PRADESH (28),10-14,8201595,4208884,3992711
28,ANDHRA PRADESH (28),15-19,8093747,4196307,3897440
28,ANDHRA PRADESH (28),20-24,8132094,4055697,4076397
28,ANDHRA PRADESH (28),25-29,7799036,3809887,3989149
28,ANDHRA PRADESH (28),30-34,6584371,3300407,3283964
28,ANDHRA PRADESH (28),35-39,6507339,3198512,3308827
28,ANDHRA PRADESH (28),40-44,5399473,2794398,2605075
28,ANDHRA PRADESH (28),45-49,4657269,2374633,2282636
28,ANDHRA PRADESH (28),50-54,3657386,1862583,1794803
28,ANDHRA PRADESH (28),55-59,2909598,1350539,1559059
28,ANDHRA PRADESH (28),60-64,3199837,1485764,1714073
28,ANDHRA PRADESH (28),65-69,2167854,1034360,1133494
28,ANDHRA PRADESH (28),70-74,1519358,752743,766615
28,ANDHRA PRADESH (28),75-79,636989,307474,329515
28,ANDHRA PRADESH (28),80+,754203,325987,428216
28,ANDHRA PRADESH (28),Age not stated,771431,387686,383745
29,KARNATAKA (29),All ages,61095297,30966657,30128640
29,KARNATAKA (29),0-4,5046719,2582024,2464695
29,KARNATAKA (29),5-9,5241509,2696670,2544839
29,KARNATAKA (29),10-14,5736646,2955287,2781359
29,KARNATAKA (29),15-19,5827277,3042048,2785229
29,KARNATAKA (29),20-24,6052558,3109586,2942972
29,KARNATAKA (29),25-29,5771606,2879254,2892352
29,KARNATAKA (29),30-34,4698380,2389594,2308786
29,KARNATAKA (29),35-39,4695451,2319088,2376363
29,KARNATAKA (29),40-44,3826712,1977768,1848944
29,KARNATAKA (29),45-49,3519782,1804833,1714949
29,KARNATAKA (29),50-54,2699270,1381969,1317301
29,KARNATAKA (29),55-59,2142504,1056054,1086450
29,KARNATAKA (29),60-64,2060052,994630,1065422
29,KARNATAKA (29),65-69,1520119,723687,796432
29,KARNATAKA (29),70-74,1061125,510419,550706
29,KARNATAKA (29),75-79,524426,249834,274592
29,KARNATAKA (29),80+,625310,268502,356808
29,KARNATAKA (29),Age not stated,45851,25410,20441
30,GOA (30),All ages,1458545,739140,719405
30,GOA (30),0-4,101203,52017,49186
30,GOA (30),5-9,105968,54672,51296
30,GOA (30),10-14,110989,57417,53572
30,GOA (30),15-19,113875,60075,53800
30,GOA (30),20-24,130745,70616,60129
30,GOA (30),25-29,132626,67744,64882
30,GOA (30),30-34,125859,63471,62388
30,GOA (30),35-39,126298,63541,62757
30,GOA (30),40-44,108512,55504,53008
30,GOA (30),45-49,94736,47867,46869
30,GOA (30),50-54,76592,38782,37810
30,GOA (30),55-59,65553,32021,33532
30,GOA (30),60-64,61104,29100,32004
30,GOA (30),65-69,41019,19005,22014
30,GOA (30),70-74,29055,12890,16165
30,GOA (30),75-79,16536,7228,9308
30,GOA (30),80+,15781,6092,9689
30,GOA (30),Age not stated,2094,1098,996
31,LAKSHADWEEP (31),All ages,64473,33123,31350
31,LAKSHADWEEP (31),0-4,5052,2648,2404
31,LAKSHADWEEP (31),5-9,5407,2760,2647
31,LAKSHADWEEP (31),10-14,5998,2854,3144
31,LAKSHADWEEP (31),15-19,5624,2808,2816
31,LAKSHADWEEP (31),20-24,5829,3071,2758
31,LAKSHADWEEP (31),25-29,5967,3135,2832
31,LAKSHADWEEP (31),30-34,5437,2777,2660
31,LAKSHADWEEP (31),35-39,5389,2756,2633
31,LAKSHADWEEP (31),40-44,4608,2453,2155
31,LAKSHADWEEP (31),45-49,3810,1975,1835
31,LAKSHADWEEP (31),50-54,3066,1625,1441
31,LAKSHADWEEP (31),55-59,2901,1513,1388
31,LAKSHADWEEP (31),60-64,2034,1046,988
31,LAKSHADWEEP (31),65-69,1413,753,660
31,LAKSHADWEEP (31),70-74,849,410,439
31,LAKSHADWEEP (31),75-79,493,244,249
31,LAKSHADWEEP (31),80+,481,221,260
31,LAKSHADWEEP (31),Age not stated,115,74,41
32,KERALA (32),All ages,33406061,16027412,17378649
32,KERALA (32),0-4,2453092,1247534,1205558
32,KERALA (32),5-9,2555112,1303190,1251922
32,KERALA (32),10-14,2822770,1438917,1383853
32,KERALA (32),15-19,2610552,1328299,1282253
32,KERALA (32),20-24,2665809,1298826,1366983
32,KERALA (32),25-29,2604092,1203978,1400114
32,KERALA (32),30-34,2455501,1128217,1327284
32,KERALA (32),35-39,2579673,1161819,1417854
32,KERALA (32),40-44,2412498,1117424,1295074
32,KERALA (32),45-49,2348530,1105598,1242932
32,KERALA (32),50-54,1928145,931191,996954
32,KERALA (32),55-59,1742408,861527,880881
32,KERALA (32),60-64,1414671,685136,729535
32,KERALA (32),65-69,1002134,459232,542902
32,KERALA (32),70-74,733372,326562,406810
32,KERALA (32),75-79,501367,208317,293050
32,KERALA (32),80+,541849,204348,337501
32,KERALA (32),Age not stated,34486,17297,17189
33,TAMIL NADU (33),All ages,72147030,36137975,36009055
33,TAMIL NADU (33),0-4,5278701,2714578,2564123
33,TAMIL NADU (33),5-9,5551255,2851293,2699962
33,TAMIL NADU (33),10-14,6177547,3188990,2988557
33,TAMIL NADU (33),15-19,6253792,3229838,3023954
33,TAMIL NADU (33),20-24,6411543,3154804,3256739
33,TAMIL NADU (33),25-29,6663746,3237374,3426372
33,TAMIL NADU (33),30-34,5815560,2908749,2906811
33,TAMIL NADU (33),35-39,5836456,2815205,3021251
33,TAMIL NADU (33),40-44,5064209,2549846,2514363
33,TAMIL NADU (33),45-49,4713056,2374915,2338141
33,TAMIL NADU (33),50-54,3703460,1875563,1827897
33,TAMIL NADU (33),55-59,3101142,1540924,1560218
33,TAMIL NADU (33),60-64,2782608,1378039,1404569
33,TAMIL NADU (33),65-69,1868370,896412,971958
33,TAMIL NADU (33),70-74,1406529,693167,713362
33,TAMIL NADU (33),75-79,710241,353746,356495
33,TAMIL NADU (33),80+,742010,339862,402148
33,TAMIL NADU (33),Age not stated,66805,34670,32135
34,PUDUCHERRY (34),All ages,1247953,612511,635442
34,PUDUCHERRY (34),0-4,93949,47703,46246
34,PUDUCHERRY (34),5-9,98717,50327,48390
34,PUDUCHERRY (34),10-14,105726,53936,51790
34,PUDUCHERRY (34),15-19,102316,52231,50085
34,PUDUCHERRY (34),20-24,108819,51287,57532
34,PUDUCHERRY (34),25-29,118244,55052,63192
34,PUDUCHERRY (34),30-34,111070,53761,57309
34,PUDUCHERRY (34),35-39,107459,52655,54804
34,PUDUCHERRY (34),40-44,89779,45482,44297
34,PUDUCHERRY (34),45-49,79305,40625,38680
34,PUDUCHERRY (34),50-54,60923,30858,30065
34,PUDUCHERRY (34),55-59,50109,24615,25494
34,PUDUCHERRY (34),60-64,43828,20498,23330
34,PUDUCHERRY (34),65-69,27983,12154,15829
34,PUDUCHERRY (34),70-74,22521,9861,12660
34,PUDUCHERRY (34),75-79,12789,5494,7295
34,PUDUCHERRY (34),80+,13315,5412,7903
34,PUDUCHERRY (34),Age not stated,1101,560,541
35,ANDAMAN & NICOBAR ISLANDS (35),All ages,380581,202871,177710
35,ANDAMAN & NICOBAR ISLANDS (35),0-4,28754,14641,14113
35,ANDAMAN & NICOBAR ISLANDS (35),5-9,30454,15512,14942
35,ANDAMAN & NICOBAR ISLANDS (35),10-14,33467,17118,16349
35,ANDAMAN & NICOBAR ISLANDS (35),15-19,33026,17266,15760
35,ANDAMAN & NICOBAR ISLANDS (35),20-24,37115,19528,17587
35,ANDAMAN & NICOBAR ISLANDS (35),25-29,41722,22230,19492
35,ANDAMAN & NICOBAR ISLANDS (35),30-34,35723,19359,16364
35,ANDAMAN & NICOBAR ISLANDS (35),35-39,32842,17170,15672
35,ANDAMAN & NICOBAR ISLANDS (35),40-44,26735,14813,11922
35,ANDAMAN & NICOBAR ISLANDS (35),45-49,23861,13270,10591
35,ANDAMAN & NICOBAR ISLANDS (35),50-54,17296,9710,7586
35,ANDAMAN & NICOBAR ISLANDS (35),55-59,13794,7870,5924
35,ANDAMAN & NICOBAR ISLANDS (35),60-64,10376,5807,4569
35,ANDAMAN & NICOBAR ISLANDS (35),65-69,6226,3430,2796
35,ANDAMAN & NICOBAR ISLANDS (35),70-74,4098,2378,1720
35,ANDAMAN & NICOBAR ISLANDS (35),75-79,2251,1295,956
35,ANDAMAN & NICOBAR ISLANDS (35),80+,2473,1279,1194
35,ANDAMAN & NICOBAR ISLANDS (35),Age not stated,368,195,173
